//set room variables first
//set room width must match the width of all the lines below,do not put a space after equals
{{room_width}} =21
//set room height must match the height of all the lines below,do not put a space after equals
{{room_height}} =11
//sets the amount of rooms in this file, this must match
{{room_count}} =5
000000000000000000000
000000000000000000000
000000000000000000000
000000000000000000000
000000000000000000000
000000000000000000000
000000000000000000000
000000000000000000000
111100000000000001111
111102220222022201111
111100000000000001111
//always finish a room with the new room flag as shown below on line 13 and 18
{{new_room}}
000000000000000000000
000000000000000000000
000000000000000000000
000000000000000000000
000000000000000000000
000002220000022200000
000000000000000000000
000000000000000000000
111111111000111111111
111111111000111111111
111111111000111111111
{{new_room}}
000000000000000000000
000000000000000000000
000000000000000000000
000000000000000000000
000000000000000000000
000000000000000000000
000022220000000000000
000000000000000000000
000000000001111100000
111111111111111111111
111111111111111111111
{{new_room}}
000000000000000000000
000000000000000000000
000000000000000000000
000000000000000000000
000000000000000000000
000000000100000000000
000000001100022220000
000000011100000000000
111111111100000000011
111111111100000000011
111111111100000000011
{{new_room}}
000000000000000000000
000000000000000000000
000000000000000000000
000000000000000000000
000000000000000000000
000000000000000000000
000000000200222200000
000000200000000000000
111100000000000001111
111100000000000001111
111100000000000001111
{{new_room}}
