//set room variables first
//set room width must match the width of all the lines below,do not put a space after equals
{{room_width}} =21
//set room height must match the height of all the lines below,do not put a space after equals
{{room_height}} =11
//sets the amount of rooms in this file, this must match
{{room_count}} =5
000000000000000000000
000000000000000000000
000000000000000000000
000000000000000000000
000000000000000000000
000000000000000000000
000000000000000000000
000000000000000000000
111100000000000001111
111101110111011101111
111100000000000001111
//always finish a room with the new room flag as shown below on line 13 and 18
{{new_room}}
000000000000000000000
000000000000000000000
000000000000000000000
000000000000000000000
000000000000000000000
000000000000000000000
000000000000000000000
000090000000000000000
111111111000111111111
111111111000111111111
111111111000111111111
{{new_room}}
000000000000000000000
000000000000000000000
000000000000000000000
011111111111111111110
013333333333333333310
013333333333333333310
013311111111111113310
023333333333333333320
023333333333333333320
111111111111111111111
111111111111111111111
{{new_room}}
000000000000000000000
000000000000000000000
000000000000000000000
000000000000000000000
000000000000000000000
000000000100000000000
000000001100011110000
000000011100000000000
111111111100000000011
111111111100000000011
111111111100000000011
{{new_room}}
000000000000000000000
000000000000000000000
000000000000000000000
000000000000000000000
000000000000000000000
000000000000000000000
000000000100111100000
000000100000000000000
111100000000000001111
111100000000000001111
111100000000000001111
{{new_room}}
